1111111111
1P00100011
10C0100001
1000E00001
1011100001
1000000001
100L000001
100000C001
1000000001
1111111111
