11111
1C0S1
1P001
1E001
1C0W1
11111