1111111111
1P00100E01
10C0100001
1000100001
1011100001
10000000S1
100W000001
100000C001
1000000001
1111111111
